Wrong	Right
abi	ağabey
acaip	acayip
acenta	acente
acitasyon	ajitasyon
adale	adele
afaroz	aforoz
afilli	afili
ahçı	aşçı
ahlağa	ahlaka
ahlağı	ahlakı
ahlağın	ahlakın
akapunktur	akupunktur
akibet	akıbet
akrapol	akropol
aliminyum	alüminyum
alimünyum	alüminyum
Allahü Teala	Allahutaala
allerji	alerji
alt yapı	altyapı
ambians	ambiyans
an ve an	anbean
anfi	amfi
Ankara'lı	Ankaralı
anotomi	anatomi
Antartika	Antarktika
antiparantez	antrparantez
antreman	antrenman
apandist	apandisit
aparatif	aperitif
aperatif	aperitif
arasıra	ara sıra
ardarda	art arda
ardısıra	ardı sıra
arefe	arife
arozöz	arazöz
arttırılma	artırılma
arttırır	artırır
arttırmak	artırmak
arzederim	arz ederim
askari	asgari
asvalt	asfalt
aşçı	aşçı
aşil tendonu	Aşil tendonu
aşkolsun	aşk olsun
at binmek	ata binmek
ataç	ataş
Atatürkçülük'ü	Atatürkçülüğü
ateşe	ataşe
atmış	altmış
ayrıyeten	ayrıca
ayrıyetten	ayrıca
Azarbaycan	Azerbaycan
Azarbeycan	Azerbaycan
azerbaycan	azerbaycan
Azerbeycan	Azerbaycan
bahçevan	bahçıvan
bahçivan	bahçıvan
banane	bana ne
barsak	bağırsak
baya	bayağı
benle	benimle
beynelminel	beynelmilel
bilader	birader
bilimum	bilumum
bilinç altı	bilinçaltı
bilmemezlik	bilmezlik
bilmemezlikten	bilmezlikten
bir biri	birbiri
bir çok	birçok
bir haber	bihaber
bir kaç	birkaç
birarada	bir arada
biraraya	bir araya
birfiil	bilfiil
birhaber	bihaber
biribiri	birbiri
biribirine	birbirine
birşey	bir şey
biyolojist	biyolog
bizle	bizimle
bloğu	bloku
bu gün	bugün
bugünki	bugünkü
bumbar	mumbar
burada	burda
büluğ	buluğ
büsküüt	bisküvi
büsküvi	bisküvi
büyültmek	büyütmek
by-pass	baypas
cemetmek	cem etmek
cereyan	ceryan
cıvata	civata
civa	cıva
çiğ börek	çi börek
çünki	çünkü
darp etmek	darbetmek
dedektif	detektif
def olmak	defolmak
dersane	dershane
devirdaim	devridaim
deyinmek	değinmek
diaspora	diyaspora
dinozor	dinazor
direk	direkt
distribütör	distribütör
doğalgaz	doğal gaz
Doğubeyazıt	Doğubayazıt
döküman	doküman
döndermek	döndürmek
düz yazı	düzyazı
egsos	egzoz
egsoz	egzoz
egzantrik	eksantrik
egzos	egzoz
egzost	egzoz
ehl-i beyt	ehlibeyit
ehlibeyt	ehlibeyit
eksos	egzoz
eksoz	egzoz
ekzantrik	eksantrik
ekzoz	egzoz
ençok	en çok
entellektüel	entelektüel
erezyon	erozyon
eskaza	ezkaza
espiri	espri
eşki	ekşi
eşkiya	eşkıya
eşortman	eşofman
eşşek	eşek
euro	avro
evrağı	evrakı
evraklar	evrak
evye	eviye
eylence	eğlence
farketmek	fark etmek
farzetmek	farz etmek
fasülya	fasulye
fasülye	fasulye
felan	falan
felsefik	felsefi
Finli	Fin
florasan	floresan
fortmanto	portmanto
gardolap	gardırop
gardrop	gardırop
garez	garaz
gasp etmek	gasbetmek
gavat	kavat
gay	gey
geçtiğimiz ay	geçen ay
geçtiğimiz gün	geçen gün
geçtiğimiz hafta	geçen hafta
glukoz	glikoz
gluten	glüten
görmemezlik	görmezlik
görmemezlikten	görmezlikten
göya	güya
göz yaşı	gözyaşı
grızüü	grizu
grizü	grizu
hadsafhada	had safhada
Hakkari	Hakkâri
halikar	hâlükâr
halukar	hâlükâr
hapşurmak	hapşırmak
hapşuruk	hapşırık
harem selamlık	haremlik selamlık
harfiyat	hafriyat
hasıraltı	hasır altı
hastahane	hastane
hatasıyla sevabıyla	hatasıyla savabıyla
hatrı	hatırı
hatrım	hatırım
hatrımız	hatırımız
hayli hayli	haydi haydi
hazır cevap	hazırcevap
hem fikir	hemfikir
hemşeri	hemşehri
hemşir	hemşire
her hangi bir	herhangi bir
herbir	her bir
herbiri	her biri
hergün	her gün
herhangibir	herhangi bir
herkez	herkes
herşey	her şey
herzaman	her zaman
hiçkimse	hiç kimse
Hintli	Hint
hizmetiçi	hizmet içi
hoş beş	hoşbeş
hoşçakal	hoşça kal
hoşçakalmak	hoşça kalmak
hoşgelmek	hoş gelmek
Hristiyanlık'ta	Hristiyanlıkta
hukuğa	hukuka
hukuğu	hukuku
hukuğun	hukukun
hükümet	hükûmet
ırsi	irsî
ırsî	irsî
ıstırap	ıztırap
idda	iddia
iddaa	iddia
ilizyon	illüzyon
ilkönce	ilk önce
ilkyardım	ilk yardım
illa ki	illaki
ilustrasyon	illüstrasyon
ilüstrasyon	illüstrasyon
ilüzyon	illüzyon
imza sirküsü	imza sirküleri
inkilap	inkılap
insiyatif	inisiyatif
istepne	stepne
itibariyla	itibarıyla
itibariyle	itibarıyla
Iztırap	ıstırap
i̇çerde	içeride
i̇nsiyatif	inisiyatif
i̇şbirliği	iş birliği
i̇tibariyle	itibarıyla
i̇zalasyon	izolasyon
jip	cip
jop	cop
kalemşör	kalemşor
kanepe	kanape
kapşon	kapüşon
karakutu	kara kutu
karayolu	kara yolu
kareografi	koreografi
karisör	karoser
karma karışık	karmakarışık
karnıbahar	karnabahar
karsör	karoser
kat sayı	katsayı
kat ve kat	katbekat
katetmek	kat etmek
kayyum	kayyım
kıraathane	kıraathane
kıravat	kravat
kırkikindi	kırk ikindi
kilot	külot
kiprik	kirpik
kitapevi	kitabevi
klavuz	kılavuz
kolleksiyon	koleksiyon
kollektif	kolektif
kolonyağı	kolonya
komidin	komodin
kominikasyon	komünikasyon
komünükasyon	komünikasyon
konservatuar	konservatuvar
konteynır	konteyner
kontraplak	kontrplak
kontür	kontur
kontür	kontör
krathane	kıraathane
küfür etmek	küfretmek
küme çıkmak	kümeye çıkmak
küpür	kupür
küsür	küsur
küvöz	kuvöz
labaratuar	laboratuvar
laboratuar	laboratuvar
laboratuvar	laboratuvar
laborotuar	laboratuvar
labratuvar	laboratuvar
lakayt	lakayıt
lavobo	lavabo
laylon	naylon
logar	rögar
madem ki	mademki
mahçup	mahcup
makina	makine
malesef	maalesef
malumun ilanı	malumun ilamı
mantalite	mentalite
marihuana	marijuana
maskulen	maskülen
mataryel	materyal
maydonoz	maydanoz
mazallah	maazallah
mebla	meblağ
mefta	mevta
melemen	menemen
men etmek	menetmek
menacer	menajer
menapoz	menopoz
menejer	menajer
mentor	mentör
mescid	mescit
meskür	mezkûr
metcezir	medcezir
method	metot
metod	metot
metoroloji	meteoroloji
mevzuatlar	mevzuat
meyva	meyve
mezkür	mezkûr
molotof kokteyli	molotofkokteyli
morel	moral
muhattap	muhatap
mundar	murdar
mustahak	müstahak
müddet	mühlet
mükemmelliyetçi	mükemmeliyetçi
müsade	müsaade
müsil	müshil
müstehak	müstahak
mütaakip	müteakip
mütahit	müteahhit
mütevazi	mütevazı
nacizane	naçizane
nalet	lanet
natural	natürel
naturel	natürel
ne idüğü belirsiz	ne idiği belirsiz
netekim	nitekim
neyseki	neyse ki
nufus	nüfus
nufüs	nüfus
nüfüs	nüfus
nümizmatik	nümismatik
oldubitti	oldu bitti
onla	onunla
orda	orada
orjinal	orijinal
ortadoğu	orta doğu
ortaya konmak	ortaya koymak
oysa ki	oysaki
öğe	öge
ön görü	öngörü
ön sezi	önsezi
ötenazi	ötanazi
öz geçmiş	özgeçmiş
öz ve öz	özbeöz
panaroma	panorama
panik atak	panikatak
pantalon	pantolon
parakende	perakende
pardesü	pardösü
parende	perende
parentez	parantez
pasifize	pasivize
pekçok	pek çok
peluş	pelüş
personeller	personel
peşisıra	peşi sıra
peştemal	peştamal
piercing	pirsing
pili	pile
pinpirik	pimpirik
pli	pile
poaça	poğaça
poça	poğaça
poğça	poğaça
polikinlik	poliklinik
portalı	portali
potbori	potpuri
pound	paunt
prezantabl	prezantabl
profüterol	profiterol
proğram	program
proleterya	proletarya
provakasyon	provokasyon
psikiyatrist	psikiyatr
psikolojist	psikolog
rakkam	rakam
raslamak	rastlamak
raslantı	rastlantı
reçber	rençper
rençber	rençper
repertuar	repertuvar
resmi geçit	resmigeçit
resmî geçit	resmigeçit
restorant	restoran
ritm	ritim
ropdöşambır	ropteşambır
ropteşambır	ropdöşambır
röpteşambır	ropdöşambır
rötüş	rötuş
Rumen	Romen
rüşeym	ruşeym
rütuş	rötuş
saçmasapan	saçma sapan
sağsalim	sağ salim
sanane	sana ne
sandöviç	sandviç
sarmısak	sarımsak
satınalma	satın alma
sebeb	sebep
senle	seninle
seramoni	seremoni
serbes	serbest
sevketmek	sevk etmek
seyehat	seyahat
sezaryan	sezaryen
sezeryan	sezaryen
sıyga	siga
silahşör	silahşor
silüet	siluet
sipiker	spiker
soğuk kanlı	soğukkanlı
sosyolojist	sosyolog
sözgelimi	söz gelimi
sözkonusu	söz konusu
stoğu	stoku
subap	supap
suç üstü	suçüstü
sükut-u hayal	sukutuhayal
sükutuhayal	sukutuhayal
süpriz	sürpriz
şartel	şalter
şarz	şarj
şifahi	şifai
şovinizm	şovenizm
şöför	şoför
şuan	şu an
tabiki	tabii ki
tabikide	tabii ki
tabldot	tabildot
tahtarevalli	tahtarevalli
tahtırevan	tahterevan
tahüt	taahhüt
taktir	takdir
tastik	tasdik
tasviye	tasfiye
taşaron	taşeron
TBMM'ye	TBMM'ne
tebellü	tebellüğ
tebli	tebliğ
tekrardan	yeniden
tenefüs	teneffüs
tensib	tensip
tepe taklak	tepetaklak
terketmek	terk etmek
teror	terör
terörist	terorist
terörizm	terorizm
tesbih	tespih
tesbit	tespit
testosteron	testesteron
teşfik	teşvik
tetanos	tetanoz
tıpa	tıbba
tıpı	tıbbı
tıpın	tıbbın
tiroid	tiroit
tişort	tişört
toz pembe	tozpembe
trabzan	tırabzan
transistör	transistor
tranvay	tramvay
tranzistor	transistor
tranzistör	transistor
traş	tıraş
türap	turap
Türkçe'miz	Türkçemiz
ultrasyon	ultrason
ultümatom	ültimatom
uluslar arası	uluslararası
uluslararası	uluslar arası
umrumda	umurumda
unvan	ünvan
usül	usul
ültimatom	ultimatom
ültümaton	ültimatom
üniversite	ünversite
ünüverste	üniversite
ünvan	unvan
üslub	üslup
üslup	uslup
üsteğmen	üsteğmen
üstün körü	üstünkörü
üzre	üzere
vaad etmek	vadetmek
vaat etmek	vadetmek
vad etmek	vadetmek
Vandal	vandal
vaz geçmek	vazgeçmek
ve ya	veya
vehamet	vahamet
vejeteryan	vejetaryen
Venezüella	Venezuela
virtüöz	virtüoz
vucüt	vücut
ya herru ya merru	ya herrü ya merrü
yada	ya da
yakan top	yakantop
yakınen	yakından
yalnış	yanlış
yanar dağ	yanardağ
yanı sıra	yanısıra
yanlız	yalnız
yanyana	yan yana
Yaratan	Yaradan
yasadışı	yasa dışı
yayınlamak	yayımlamak
Yeni Zellanda	Yeni Zelanda
yeralmak	yer almak
yıl başı	yılbaşı
yinede	yine de
yövmiye	yevmiye
yükseköğrenim	yükseköğretim
zebellah	zebella
zehir etmek	zehretmek
zerafet	zarafet
zeytin yağı	zeytinyağı
zıttı	zıddı
